5
5
bWALL bWALL bWALL bWALL bWALL
..... ..... tBABA tIS__ tYOU_
bBABA ..... ..... bFLAG .....
..... bROCK ..... bROCK .....
..... ..... bWALL ..... .....

